datetime,D,NG,Diff,Day,Hour,CloseToLimit,Month
2024-01-01 00:00:00,3538,3390,-148,2024-01-01,0,True,2024-01
2024-01-01 01:00:00,3493,3242,-251,2024-01-01,1,True,2024-01
2024-01-01 02:00:00,3423,3131,-292,2024-01-01,2,True,2024-01
2024-01-01 03:00:00,3322,2981,-341,2024-01-01,3,True,2024-01
2024-01-01 04:00:00,3257,2860,-397,2024-01-01,4,True,2024-01
2024-01-01 05:00:00,3170,2882,-288,2024-01-01,5,True,2024-01
2024-01-01 06:00:00,3104,2823,-281,2024-01-01,6,True,2024-01
2024-01-01 07:00:00,3045,2903,-142,2024-01-01,7,True,2024-01
2024-01-01 08:00:00,3000,2965,-35,2024-01-01,8,True,2024-01
2024-01-01 09:00:00,2990,3064,74,2024-01-01,9,True,2024-01
2024-01-01 11:00:00,3038,3177,139,2024-01-01,11,True,2024-01
2024-01-01 12:00:00,3090,3144,54,2024-01-01,12,True,2024-01
2024-01-01 13:00:00,3181,3222,41,2024-01-01,13,True,2024-01
2024-01-01 14:00:00,3284,3357,73,2024-01-01,14,True,2024-01
2024-01-01 15:00:00,3351,3271,-80,2024-01-01,15,True,2024-01
2024-01-01 16:00:00,3453,3349,-104,2024-01-01,16,True,2024-01
2024-01-01 17:00:00,3451,3354,-97,2024-01-01,17,True,2024-01
2024-01-01 18:00:00,3412,3387,-25,2024-01-01,18,True,2024-01
2024-01-01 19:00:00,3270,3407,137,2024-01-01,19,True,2024-01
2024-01-01 22:00:00,3030,3205,175,2024-01-01,22,True,2024-01
2024-01-01 23:00:00,3166,3206,40,2024-01-01,23,True,2024-01
2024-01-02 00:00:00,3453,3338,-115,2024-01-02,0,True,2024-01
2024-01-02 01:00:00,3629,3430,-199,2024-01-02,1,True,2024-01
2024-01-02 02:00:00,3633,3632,-1,2024-01-02,2,True,2024-01
2024-01-02 03:00:00,3667,3726,59,2024-01-02,3,True,2024-01
2024-01-02 07:00:00,3418,3617,199,2024-01-02,7,True,2024-01
2024-01-02 08:00:00,3425,3619,194,2024-01-02,8,True,2024-01
2024-01-02 13:00:00,3918,4023,105,2024-01-02,13,True,2024-01
2024-01-02 14:00:00,3977,3945,-32,2024-01-02,14,True,2024-01
2024-01-02 15:00:00,3876,3965,89,2024-01-02,15,True,2024-01
2024-01-02 16:00:00,3708,3919,211,2024-01-02,16,True,2024-01
2024-01-03 12:00:00,3581,3764,183,2024-01-03,12,True,2024-01
2024-01-03 13:00:00,3826,3836,10,2024-01-03,13,True,2024-01
2024-01-03 14:00:00,3898,3875,-23,2024-01-03,14,True,2024-01
2024-01-03 15:00:00,3789,3940,151,2024-01-03,15,True,2024-01
2024-01-04 13:00:00,3696,3854,158,2024-01-04,13,True,2024-01
2024-01-04 14:00:00,3754,3850,96,2024-01-04,14,True,2024-01
2024-01-04 15:00:00,3686,3869,183,2024-01-04,15,True,2024-01
2024-01-06 00:00:00,3493,3594,101,2024-01-06,0,True,2024-01
2024-01-06 01:00:00,3475,3581,106,2024-01-06,1,True,2024-01
2024-01-06 02:00:00,3427,3507,80,2024-01-06,2,True,2024-01
2024-01-08 12:00:00,3301,3365,64,2024-01-08,12,True,2024-01
2024-01-08 13:00:00,3535,3631,96,2024-01-08,13,True,2024-01
2024-01-08 14:00:00,3602,3798,196,2024-01-08,14,True,2024-01
2024-01-08 17:00:00,3552,3774,222,2024-01-08,17,True,2024-01
2024-01-08 18:00:00,3550,3683,133,2024-01-08,18,True,2024-01
2024-01-09 00:00:00,3792,3879,87,2024-01-09,0,True,2024-01
2024-01-09 01:00:00,3799,3681,-118,2024-01-09,1,True,2024-01
2024-01-09 02:00:00,3712,3573,-139,2024-01-09,2,True,2024-01
2024-01-09 03:00:00,3623,3496,-127,2024-01-09,3,True,2024-01
2024-01-09 04:00:00,3420,3247,-173,2024-01-09,4,True,2024-01
2024-01-09 05:00:00,3249,3043,-206,2024-01-09,5,True,2024-01
2024-01-09 06:00:00,3061,2760,-301,2024-01-09,6,True,2024-01
2024-01-09 07:00:00,3006,2571,-435,2024-01-09,7,True,2024-01
2024-01-09 08:00:00,2975,2580,-395,2024-01-09,8,True,2024-01
2024-01-09 09:00:00,2974,2566,-408,2024-01-09,9,True,2024-01
2024-01-09 10:00:00,2985,2593,-392,2024-01-09,10,True,2024-01
2024-01-09 11:00:00,3055,2747,-308,2024-01-09,11,True,2024-01
2024-01-09 12:00:00,3203,2908,-295,2024-01-09,12,True,2024-01
2024-01-09 13:00:00,3432,3219,-213,2024-01-09,13,True,2024-01
2024-01-09 14:00:00,3574,3477,-97,2024-01-09,14,True,2024-01
2024-01-09 15:00:00,3612,3639,27,2024-01-09,15,True,2024-01
2024-01-09 16:00:00,3637,3687,50,2024-01-09,16,True,2024-01
2024-01-09 17:00:00,3689,3831,142,2024-01-09,17,True,2024-01
2024-01-09 18:00:00,3702,3804,102,2024-01-09,18,True,2024-01
2024-01-09 19:00:00,3703,3822,119,2024-01-09,19,True,2024-01
2024-01-09 20:00:00,3711,3860,149,2024-01-09,20,True,2024-01
2024-01-10 02:00:00,4014,4203,189,2024-01-10,2,True,2024-01
2024-01-10 03:00:00,3917,4086,169,2024-01-10,3,True,2024-01
2024-01-10 04:00:00,3810,3840,30,2024-01-10,4,True,2024-01
2024-01-10 05:00:00,3604,3692,88,2024-01-10,5,True,2024-01
2024-01-10 06:00:00,3491,3646,155,2024-01-10,6,True,2024-01
2024-01-10 07:00:00,3438,3582,144,2024-01-10,7,True,2024-01
2024-01-10 08:00:00,3434,3569,135,2024-01-10,8,True,2024-01
2024-01-10 09:00:00,3428,3554,126,2024-01-10,9,True,2024-01
2024-01-10 10:00:00,3474,3407,-67,2024-01-10,10,True,2024-01
2024-01-10 11:00:00,3547,3547,0,2024-01-10,11,True,2024-01
2024-01-10 12:00:00,3721,3789,68,2024-01-10,12,True,2024-01
2024-01-10 13:00:00,3974,4094,120,2024-01-10,13,True,2024-01
2024-01-10 14:00:00,4059,4251,192,2024-01-10,14,True,2024-01
2024-01-11 12:00:00,3508,3625,117,2024-01-11,12,True,2024-01
2024-01-11 13:00:00,3783,3843,60,2024-01-11,13,True,2024-01
2024-01-11 14:00:00,3881,3823,-58,2024-01-11,14,True,2024-01
2024-01-11 15:00:00,3673,3779,106,2024-01-11,15,True,2024-01
2024-01-11 16:00:00,3403,3578,175,2024-01-11,16,True,2024-01
2024-01-12 03:00:00,3242,3356,114,2024-01-12,3,True,2024-01
2024-01-12 04:00:00,3098,3154,56,2024-01-12,4,True,2024-01
2024-01-12 05:00:00,2984,2998,14,2024-01-12,5,True,2024-01
2024-01-12 06:00:00,2862,2869,7,2024-01-12,6,True,2024-01
2024-01-12 07:00:00,2814,2872,58,2024-01-12,7,True,2024-01
2024-01-12 08:00:00,2799,2839,40,2024-01-12,8,True,2024-01
2024-01-12 09:00:00,2829,2832,3,2024-01-12,9,True,2024-01
2024-01-12 10:00:00,2910,2897,-13,2024-01-12,10,True,2024-01
2024-01-12 11:00:00,2986,2908,-78,2024-01-12,11,True,2024-01
2024-01-12 12:00:00,3170,3100,-70,2024-01-12,12,True,2024-01
2024-01-12 13:00:00,3464,3358,-106,2024-01-12,13,True,2024-01
2024-01-12 14:00:00,3613,3521,-92,2024-01-12,14,True,2024-01
2024-01-12 15:00:00,3709,3679,-30,2024-01-12,15,True,2024-01
2024-01-12 16:00:00,3857,3566,-291,2024-01-12,16,True,2024-01
2024-01-12 17:00:00,3968,3774,-194,2024-01-12,17,True,2024-01
2024-01-12 18:00:00,4067,3765,-302,2024-01-12,18,True,2024-01
2024-01-12 19:00:00,4178,3758,-420,2024-01-12,19,True,2024-01
2024-01-12 20:00:00,4224,3865,-359,2024-01-12,20,True,2024-01
2024-01-12 21:00:00,4287,3891,-396,2024-01-12,21,True,2024-01
2024-01-12 22:00:00,4351,3924,-427,2024-01-12,22,True,2024-01
2024-01-12 23:00:00,4488,4026,-462,2024-01-12,23,True,2024-01
2024-01-13 00:00:00,4706,4207,-499,2024-01-13,0,True,2024-01
2024-01-13 01:00:00,4776,4143,-633,2024-01-13,1,True,2024-01
2024-01-13 02:00:00,4740,4042,-698,2024-01-13,2,True,2024-01
2024-01-13 03:00:00,4718,4183,-535,2024-01-13,3,True,2024-01
2024-01-13 04:00:00,4646,4145,-501,2024-01-13,4,True,2024-01
2024-01-13 05:00:00,4543,4090,-453,2024-01-13,5,True,2024-01
2024-01-13 06:00:00,4445,4002,-443,2024-01-13,6,True,2024-01
2024-01-13 07:00:00,4427,3700,-727,2024-01-13,7,True,2024-01
2024-01-13 08:00:00,4395,3628,-767,2024-01-13,8,True,2024-01
2024-01-13 09:00:00,4418,3626,-792,2024-01-13,9,True,2024-01
2024-01-13 10:00:00,4461,3626,-835,2024-01-13,10,True,2024-01
2024-01-13 11:00:00,4520,3656,-864,2024-01-13,11,True,2024-01
2024-01-13 12:00:00,4628,3857,-771,2024-01-13,12,True,2024-01
2024-01-13 13:00:00,4734,3896,-838,2024-01-13,13,True,2024-01
2024-01-13 14:00:00,4840,3795,-1045,2024-01-13,14,True,2024-01
2024-01-13 15:00:00,4868,3677,-1191,2024-01-13,15,True,2024-01
2024-01-13 16:00:00,4762,3608,-1154,2024-01-13,16,True,2024-01
2024-01-13 17:00:00,4665,3571,-1094,2024-01-13,17,True,2024-01
2024-01-13 18:00:00,4510,3576,-934,2024-01-13,18,True,2024-01
2024-01-13 19:00:00,4380,3464,-916,2024-01-13,19,True,2024-01
2024-01-13 20:00:00,4312,3383,-929,2024-01-13,20,True,2024-01
2024-01-13 21:00:00,4262,3359,-903,2024-01-13,21,True,2024-01
2024-01-13 22:00:00,4377,3466,-911,2024-01-13,22,True,2024-01
2024-01-13 23:00:00,4577,3525,-1052,2024-01-13,23,True,2024-01
2024-01-14 00:00:00,4843,3656,-1187,2024-01-14,0,True,2024-01
2024-01-14 01:00:00,5007,3730,-1277,2024-01-14,1,True,2024-01
2024-01-14 02:00:00,5052,3790,-1262,2024-01-14,2,True,2024-01
2024-01-14 03:00:00,5125,3893,-1232,2024-01-14,3,True,2024-01
2024-01-14 04:00:00,5182,3897,-1285,2024-01-14,4,True,2024-01
2024-01-14 05:00:00,5238,3949,-1289,2024-01-14,5,True,2024-01
2024-01-14 06:00:00,5215,3902,-1313,2024-01-14,6,True,2024-01
2024-01-14 07:00:00,5242,3792,-1450,2024-01-14,7,True,2024-01
2024-01-14 08:00:00,5320,3882,-1438,2024-01-14,8,True,2024-01
2024-01-14 09:00:00,5381,3874,-1507,2024-01-14,9,True,2024-01
2024-01-14 10:00:00,5437,3853,-1584,2024-01-14,10,True,2024-01
2024-01-14 11:00:00,5495,3971,-1524,2024-01-14,11,True,2024-01
2024-01-14 12:00:00,5607,4041,-1566,2024-01-14,12,True,2024-01
2024-01-14 13:00:00,5749,4151,-1598,2024-01-14,13,True,2024-01
2024-01-14 14:00:00,5855,4085,-1770,2024-01-14,14,True,2024-01
2024-01-14 15:00:00,5911,4172,-1739,2024-01-14,15,True,2024-01
2024-01-14 16:00:00,5903,4294,-1609,2024-01-14,16,True,2024-01
2024-01-14 17:00:00,5895,4535,-1360,2024-01-14,17,True,2024-01
2024-01-14 18:00:00,5878,4468,-1410,2024-01-14,18,True,2024-01
2024-01-14 19:00:00,5856,4473,-1383,2024-01-14,19,True,2024-01
2024-01-14 20:00:00,5789,4516,-1273,2024-01-14,20,True,2024-01
2024-01-14 21:00:00,5739,4515,-1224,2024-01-14,21,True,2024-01
2024-01-14 22:00:00,5705,4460,-1245,2024-01-14,22,True,2024-01
2024-01-14 23:00:00,5761,4489,-1272,2024-01-14,23,True,2024-01
2024-01-15 00:00:00,5921,4534,-1387,2024-01-15,0,True,2024-01
2024-01-15 01:00:00,5927,4384,-1543,2024-01-15,1,True,2024-01
2024-01-15 02:00:00,5889,4364,-1525,2024-01-15,2,True,2024-01
2024-01-15 03:00:00,5825,4324,-1501,2024-01-15,3,True,2024-01
2024-01-15 04:00:00,5739,4400,-1339,2024-01-15,4,True,2024-01
2024-01-15 05:00:00,5626,4303,-1323,2024-01-15,5,True,2024-01
2024-01-15 06:00:00,5519,4296,-1223,2024-01-15,6,True,2024-01
2024-01-15 07:00:00,5559,4291,-1268,2024-01-15,7,True,2024-01
2024-01-15 08:00:00,5545,4236,-1309,2024-01-15,8,True,2024-01
2024-01-15 09:00:00,5565,4310,-1255,2024-01-15,9,True,2024-01
2024-01-15 10:00:00,5566,4313,-1253,2024-01-15,10,True,2024-01
2024-01-15 11:00:00,5658,4296,-1362,2024-01-15,11,True,2024-01
2024-01-15 12:00:00,5728,4273,-1455,2024-01-15,12,True,2024-01
2024-01-15 13:00:00,5857,4131,-1726,2024-01-15,13,True,2024-01
2024-01-15 14:00:00,5937,4161,-1776,2024-01-15,14,True,2024-01
2024-01-15 15:00:00,5979,4221,-1758,2024-01-15,15,True,2024-01
2024-01-15 16:00:00,5869,4237,-1632,2024-01-15,16,True,2024-01
2024-01-15 17:00:00,5727,4223,-1504,2024-01-15,17,True,2024-01
2024-01-15 18:00:00,5560,4165,-1395,2024-01-15,18,True,2024-01
2024-01-15 19:00:00,5438,4210,-1228,2024-01-15,19,True,2024-01
2024-01-15 20:00:00,5381,4180,-1201,2024-01-15,20,True,2024-01
2024-01-15 21:00:00,5342,4082,-1260,2024-01-15,21,True,2024-01
2024-01-15 22:00:00,5388,4088,-1300,2024-01-15,22,True,2024-01
2024-01-15 23:00:00,5445,4213,-1232,2024-01-15,23,True,2024-01
2024-01-16 00:00:00,5607,4214,-1393,2024-01-16,0,True,2024-01
2024-01-16 01:00:00,5729,4250,-1479,2024-01-16,1,True,2024-01
2024-01-16 02:00:00,5702,4343,-1359,2024-01-16,2,True,2024-01
2024-01-16 03:00:00,5664,4481,-1183,2024-01-16,3,True,2024-01
2024-01-16 04:00:00,5577,4574,-1003,2024-01-16,4,True,2024-01
2024-01-16 05:00:00,5431,4438,-993,2024-01-16,5,True,2024-01
2024-01-16 06:00:00,5391,4410,-981,2024-01-16,6,True,2024-01
2024-01-16 07:00:00,5366,4379,-987,2024-01-16,7,True,2024-01
2024-01-16 08:00:00,5333,4420,-913,2024-01-16,8,True,2024-01
2024-01-16 09:00:00,5431,4466,-965,2024-01-16,9,True,2024-01
2024-01-16 10:00:00,5479,4472,-1007,2024-01-16,10,True,2024-01
2024-01-16 11:00:00,5611,4704,-907,2024-01-16,11,True,2024-01
2024-01-16 12:00:00,5772,4702,-1070,2024-01-16,12,True,2024-01
2024-01-16 13:00:00,5970,4694,-1276,2024-01-16,13,True,2024-01
2024-01-16 14:00:00,6057,4725,-1332,2024-01-16,14,True,2024-01
2024-01-16 15:00:00,5942,4633,-1309,2024-01-16,15,True,2024-01
2024-01-16 16:00:00,5698,4409,-1289,2024-01-16,16,True,2024-01
2024-01-16 17:00:00,5467,4240,-1227,2024-01-16,17,True,2024-01
2024-01-16 18:00:00,5230,4087,-1143,2024-01-16,18,True,2024-01
2024-01-16 19:00:00,4998,4024,-974,2024-01-16,19,True,2024-01
2024-01-16 20:00:00,4858,4051,-807,2024-01-16,20,True,2024-01
2024-01-16 21:00:00,4720,3944,-776,2024-01-16,21,True,2024-01
2024-01-16 22:00:00,4700,3910,-790,2024-01-16,22,True,2024-01
2024-01-16 23:00:00,4791,3881,-910,2024-01-16,23,True,2024-01
2024-01-17 00:00:00,5238,4085,-1153,2024-01-17,0,True,2024-01
2024-01-17 01:00:00,5456,4158,-1298,2024-01-17,1,True,2024-01
2024-01-17 02:00:00,5488,4218,-1270,2024-01-17,2,True,2024-01
2024-01-17 03:00:00,5516,4159,-1357,2024-01-17,3,True,2024-01
2024-01-17 04:00:00,5431,4167,-1264,2024-01-17,4,True,2024-01
2024-01-17 05:00:00,5309,4143,-1166,2024-01-17,5,True,2024-01
2024-01-17 06:00:00,5262,4151,-1111,2024-01-17,6,True,2024-01
2024-01-17 07:00:00,5215,4134,-1081,2024-01-17,7,True,2024-01
2024-01-17 08:00:00,5203,4253,-950,2024-01-17,8,True,2024-01
2024-01-17 09:00:00,5221,4280,-941,2024-01-17,9,True,2024-01
2024-01-17 10:00:00,5214,4205,-1009,2024-01-17,10,True,2024-01
2024-01-17 11:00:00,5271,4294,-977,2024-01-17,11,True,2024-01
2024-01-17 12:00:00,5377,4402,-975,2024-01-17,12,True,2024-01
2024-01-17 13:00:00,5503,4655,-848,2024-01-17,13,True,2024-01
2024-01-17 14:00:00,5498,4731,-767,2024-01-17,14,True,2024-01
2024-01-17 15:00:00,5237,4556,-681,2024-01-17,15,True,2024-01
2024-01-17 16:00:00,4915,4350,-565,2024-01-17,16,True,2024-01
2024-01-17 17:00:00,4558,4198,-360,2024-01-17,17,True,2024-01
2024-01-17 18:00:00,4316,4161,-155,2024-01-17,18,True,2024-01
2024-01-17 19:00:00,4030,4027,-3,2024-01-17,19,True,2024-01
2024-01-17 20:00:00,3820,3835,15,2024-01-17,20,True,2024-01
2024-01-17 21:00:00,3702,3819,117,2024-01-17,21,True,2024-01
2024-01-17 22:00:00,3689,3827,138,2024-01-17,22,True,2024-01
2024-01-17 23:00:00,3834,3891,57,2024-01-17,23,True,2024-01
2024-01-18 00:00:00,4161,3959,-202,2024-01-18,0,True,2024-01
2024-01-18 01:00:00,4301,3771,-530,2024-01-18,1,True,2024-01
2024-01-18 02:00:00,4316,3827,-489,2024-01-18,2,True,2024-01
2024-01-18 03:00:00,4276,3814,-462,2024-01-18,3,True,2024-01
2024-01-18 04:00:00,4173,3726,-447,2024-01-18,4,True,2024-01
2024-01-18 05:00:00,4010,3626,-384,2024-01-18,5,True,2024-01
2024-01-18 06:00:00,3878,3625,-253,2024-01-18,6,True,2024-01
2024-01-18 07:00:00,3826,3581,-245,2024-01-18,7,True,2024-01
2024-01-18 08:00:00,3808,3543,-265,2024-01-18,8,True,2024-01
2024-01-18 09:00:00,3818,3559,-259,2024-01-18,9,True,2024-01
2024-01-18 10:00:00,3814,3636,-178,2024-01-18,10,True,2024-01
2024-01-18 11:00:00,3884,3643,-241,2024-01-18,11,True,2024-01
2024-01-18 12:00:00,4037,3767,-270,2024-01-18,12,True,2024-01
2024-01-18 13:00:00,4255,3932,-323,2024-01-18,13,True,2024-01
2024-01-18 14:00:00,4316,4057,-259,2024-01-18,14,True,2024-01
2024-01-18 15:00:00,4187,4160,-27,2024-01-18,15,True,2024-01
2024-01-18 16:00:00,3920,4121,201,2024-01-18,16,True,2024-01
2024-01-18 17:00:00,3640,3832,192,2024-01-18,17,True,2024-01
2024-01-18 19:00:00,3250,3418,168,2024-01-18,19,True,2024-01
2024-01-19 00:00:00,3726,3918,192,2024-01-19,0,True,2024-01
2024-01-19 01:00:00,3928,4051,123,2024-01-19,1,True,2024-01
2024-01-19 08:00:00,4142,4400,258,2024-01-19,8,True,2024-01
2024-01-19 09:00:00,4254,4396,142,2024-01-19,9,True,2024-01
2024-01-19 10:00:00,4418,4429,11,2024-01-19,10,True,2024-01
2024-01-19 11:00:00,4582,4457,-125,2024-01-19,11,True,2024-01
2024-01-19 12:00:00,4856,4530,-326,2024-01-19,12,True,2024-01
2024-01-19 13:00:00,5141,4497,-644,2024-01-19,13,True,2024-01
2024-01-19 14:00:00,5300,4403,-897,2024-01-19,14,True,2024-01
2024-01-19 15:00:00,5220,4337,-883,2024-01-19,15,True,2024-01
2024-01-19 16:00:00,5096,4305,-791,2024-01-19,16,True,2024-01
2024-01-19 17:00:00,4914,4469,-445,2024-01-19,17,True,2024-01
2024-01-19 18:00:00,4762,4473,-289,2024-01-19,18,True,2024-01
2024-01-19 19:00:00,4592,4468,-124,2024-01-19,19,True,2024-01
2024-01-19 20:00:00,4455,4305,-150,2024-01-19,20,True,2024-01
2024-01-19 21:00:00,4381,4516,135,2024-01-19,21,True,2024-01
2024-01-19 22:00:00,4394,4542,148,2024-01-19,22,True,2024-01
2024-01-19 23:00:00,4584,4562,-22,2024-01-19,23,True,2024-01
2024-01-20 00:00:00,4962,4487,-475,2024-01-20,0,True,2024-01
2024-01-20 01:00:00,5104,4375,-729,2024-01-20,1,True,2024-01
2024-01-20 02:00:00,5168,4503,-665,2024-01-20,2,True,2024-01
2024-01-20 03:00:00,5167,4537,-630,2024-01-20,3,True,2024-01
2024-01-20 04:00:00,5162,4598,-564,2024-01-20,4,True,2024-01
2024-01-20 05:00:00,5098,4544,-554,2024-01-20,5,True,2024-01
2024-01-20 06:00:00,5050,4489,-561,2024-01-20,6,True,2024-01
2024-01-20 07:00:00,5058,4407,-651,2024-01-20,7,True,2024-01
2024-01-20 08:00:00,5065,4238,-827,2024-01-20,8,True,2024-01
2024-01-20 09:00:00,5113,4203,-910,2024-01-20,9,True,2024-01
2024-01-20 10:00:00,5179,4231,-948,2024-01-20,10,True,2024-01
2024-01-20 11:00:00,5251,4225,-1026,2024-01-20,11,True,2024-01
2024-01-20 12:00:00,5364,4195,-1169,2024-01-20,12,True,2024-01
2024-01-20 13:00:00,5498,4177,-1321,2024-01-20,13,True,2024-01
2024-01-20 14:00:00,5612,4211,-1401,2024-01-20,14,True,2024-01
2024-01-20 15:00:00,5589,4122,-1467,2024-01-20,15,True,2024-01
2024-01-20 16:00:00,5331,4018,-1313,2024-01-20,16,True,2024-01
2024-01-20 17:00:00,5087,4042,-1045,2024-01-20,17,True,2024-01
2024-01-20 18:00:00,4775,3842,-933,2024-01-20,18,True,2024-01
2024-01-20 19:00:00,4529,3922,-607,2024-01-20,19,True,2024-01
2024-01-20 20:00:00,4293,3961,-332,2024-01-20,20,True,2024-01
2024-01-20 21:00:00,4167,3887,-280,2024-01-20,21,True,2024-01
2024-01-20 22:00:00,4113,3837,-276,2024-01-20,22,True,2024-01
2024-01-20 23:00:00,4293,3891,-402,2024-01-20,23,True,2024-01
2024-01-21 00:00:00,4655,4043,-612,2024-01-21,0,True,2024-01
2024-01-21 01:00:00,4837,4048,-789,2024-01-21,1,True,2024-01
2024-01-21 02:00:00,4937,4242,-695,2024-01-21,2,True,2024-01
2024-01-21 03:00:00,4977,4352,-625,2024-01-21,3,True,2024-01
2024-01-21 04:00:00,4925,4438,-487,2024-01-21,4,True,2024-01
2024-01-21 05:00:00,4902,4472,-430,2024-01-21,5,True,2024-01
2024-01-21 06:00:00,4878,4449,-429,2024-01-21,6,True,2024-01
2024-01-21 07:00:00,4850,4478,-372,2024-01-21,7,True,2024-01
2024-01-21 08:00:00,4846,4173,-673,2024-01-21,8,True,2024-01
2024-01-21 09:00:00,4871,4157,-714,2024-01-21,9,True,2024-01
2024-01-21 10:00:00,4890,4200,-690,2024-01-21,10,True,2024-01
2024-01-21 11:00:00,4901,4216,-685,2024-01-21,11,True,2024-01
2024-01-21 12:00:00,4987,4284,-703,2024-01-21,12,True,2024-01
2024-01-21 13:00:00,5070,4325,-745,2024-01-21,13,True,2024-01
2024-01-21 14:00:00,5178,4517,-661,2024-01-21,14,True,2024-01
2024-01-21 15:00:00,5177,4493,-684,2024-01-21,15,True,2024-01
2024-01-21 16:00:00,5016,4322,-694,2024-01-21,16,True,2024-01
2024-01-21 17:00:00,4775,4230,-545,2024-01-21,17,True,2024-01
2024-01-21 18:00:00,4580,4270,-310,2024-01-21,18,True,2024-01
2024-01-21 19:00:00,4402,4224,-178,2024-01-21,19,True,2024-01
2024-01-21 20:00:00,4263,4382,119,2024-01-21,20,True,2024-01
2024-01-21 21:00:00,4223,4395,172,2024-01-21,21,True,2024-01
2024-01-21 22:00:00,4260,4349,89,2024-01-21,22,True,2024-01
2024-01-21 23:00:00,4366,4215,-151,2024-01-21,23,True,2024-01
2024-01-22 00:00:00,4499,4212,-287,2024-01-22,0,True,2024-01
2024-01-22 01:00:00,4482,4146,-336,2024-01-22,1,True,2024-01
2024-01-22 02:00:00,4426,4303,-123,2024-01-22,2,True,2024-01
2024-01-22 03:00:00,4318,4243,-75,2024-01-22,3,True,2024-01
2024-01-22 04:00:00,4238,4294,56,2024-01-22,4,True,2024-01
2024-01-22 05:00:00,4064,4191,127,2024-01-22,5,True,2024-01
2024-01-22 06:00:00,3942,3897,-45,2024-01-22,6,True,2024-01
2024-01-22 07:00:00,3872,3702,-170,2024-01-22,7,True,2024-01
2024-01-22 08:00:00,3775,3656,-119,2024-01-22,8,True,2024-01
2024-01-22 09:00:00,3785,3726,-59,2024-01-22,9,True,2024-01
2024-01-22 10:00:00,3783,3842,59,2024-01-22,10,True,2024-01
2024-01-22 11:00:00,3814,3877,63,2024-01-22,11,True,2024-01
2024-01-22 12:00:00,3900,3980,80,2024-01-22,12,True,2024-01
2024-01-22 13:00:00,4020,3862,-158,2024-01-22,13,True,2024-01
2024-01-22 14:00:00,4063,3995,-68,2024-01-22,14,True,2024-01
2024-01-22 15:00:00,4102,3853,-249,2024-01-22,15,True,2024-01
2024-01-22 16:00:00,4162,3942,-220,2024-01-22,16,True,2024-01
2024-01-22 17:00:00,4166,3938,-228,2024-01-22,17,True,2024-01
2024-01-22 18:00:00,4134,3879,-255,2024-01-22,18,True,2024-01
2024-01-22 19:00:00,4088,3824,-264,2024-01-22,19,True,2024-01
2024-01-22 20:00:00,4003,3807,-196,2024-01-22,20,True,2024-01
2024-01-22 21:00:00,3918,3724,-194,2024-01-22,21,True,2024-01
2024-01-22 22:00:00,3900,3734,-166,2024-01-22,22,True,2024-01
2024-01-22 23:00:00,3902,3677,-225,2024-01-22,23,True,2024-01
2024-01-23 00:00:00,4080,3683,-397,2024-01-23,0,True,2024-01
2024-01-23 01:00:00,4014,3567,-447,2024-01-23,1,True,2024-01
2024-01-23 02:00:00,3958,3668,-290,2024-01-23,2,True,2024-01
2024-01-23 03:00:00,3828,3664,-164,2024-01-23,3,True,2024-01
2024-01-23 04:00:00,3707,3672,-35,2024-01-23,4,True,2024-01
2024-01-23 05:00:00,3537,3653,116,2024-01-23,5,True,2024-01
2024-01-23 06:00:00,3413,3619,206,2024-01-23,6,True,2024-01
2024-01-23 12:00:00,3442,3637,195,2024-01-23,12,True,2024-01
2024-01-23 13:00:00,3621,3686,65,2024-01-23,13,True,2024-01
2024-01-23 14:00:00,3692,3764,72,2024-01-23,14,True,2024-01
2024-01-23 15:00:00,3632,3702,70,2024-01-23,15,True,2024-01
2024-01-23 16:00:00,3557,3665,108,2024-01-23,16,True,2024-01
2024-01-23 17:00:00,3472,3656,184,2024-01-23,17,True,2024-01
2024-01-23 18:00:00,3384,3562,178,2024-01-23,18,True,2024-01
2024-01-23 19:00:00,3389,3519,130,2024-01-23,19,True,2024-01
2024-01-23 20:00:00,3318,3449,131,2024-01-23,20,True,2024-01
2024-01-23 21:00:00,3304,3442,138,2024-01-23,21,True,2024-01
2024-01-23 22:00:00,3306,3456,150,2024-01-23,22,True,2024-01
2024-01-23 23:00:00,3349,3326,-23,2024-01-23,23,True,2024-01
2024-01-24 00:00:00,3490,3297,-193,2024-01-24,0,True,2024-01
2024-01-24 01:00:00,3521,3226,-295,2024-01-24,1,True,2024-01
2024-01-24 02:00:00,3482,3288,-194,2024-01-24,2,True,2024-01
2024-01-24 03:00:00,3381,3209,-172,2024-01-24,3,True,2024-01
2024-01-24 04:00:00,3219,3193,-26,2024-01-24,4,True,2024-01
2024-01-24 14:00:00,3352,3559,207,2024-01-24,14,True,2024-01
2024-01-25 13:00:00,3170,3358,188,2024-01-25,13,True,2024-01
2024-01-25 14:00:00,3290,3371,81,2024-01-25,14,True,2024-01
2024-01-26 01:00:00,3256,3458,202,2024-01-26,1,True,2024-01
2024-01-27 15:00:00,3215,3418,203,2024-01-27,15,True,2024-01
2024-01-27 19:00:00,3314,3469,155,2024-01-27,19,True,2024-01
2024-01-27 20:00:00,3260,3196,-64,2024-01-27,20,True,2024-01
2024-01-27 21:00:00,3234,3222,-12,2024-01-27,21,True,2024-01
2024-01-27 22:00:00,3246,3394,148,2024-01-27,22,True,2024-01
2024-01-28 14:00:00,3271,3404,133,2024-01-28,14,True,2024-01
2024-01-28 15:00:00,3396,3458,62,2024-01-28,15,True,2024-01
2024-01-28 16:00:00,3400,3528,128,2024-01-28,16,True,2024-01
2024-01-28 17:00:00,3272,3434,162,2024-01-28,17,True,2024-01
2024-01-29 09:00:00,3047,3236,189,2024-01-29,9,True,2024-01
2024-01-30 12:00:00,2817,2980,163,2024-01-30,12,True,2024-01
2024-01-30 13:00:00,3100,3152,52,2024-01-30,13,True,2024-01
2024-01-30 14:00:00,3150,3278,128,2024-01-30,14,True,2024-01
2024-01-31 12:00:00,3121,3301,180,2024-01-31,12,True,2024-01
2024-01-31 13:00:00,3391,3278,-113,2024-01-31,13,True,2024-01
2024-01-31 14:00:00,3469,3510,41,2024-01-31,14,True,2024-01
2024-01-31 15:00:00,3296,3505,209,2024-01-31,15,True,2024-01
Criticality events,,,,,,380,
